11111
1E111
10001
11101
1C001
10111
100C1
11101
1P001
11111