111111111111
100000000001
100E00000001
1P0000000001
100000C00001
111111111111